###########################
#.......SSSWWWWWWWWWWWWWWW#
#..........SSSSSSWWWWWWWWW#
#................SSSWWWWWW#
#...................SSSWWW#
#..........@...........SSS#
#........................S#
#..BBB....................#
#..BBB....................#
#..BBB..............DDD...#
#..................DDDDDD.#
#....................DDDDD#
###########################