#######################################################################WWWWWWWWWWWWWWWWWWWWWWWWWWWWWWWWWWWWWWWWWWWWWWWWWWWWWWWWWWWWWWWWWWWWW
#............................................SSWWWWWWWWWWWWWWWWWWWWWWWWWWWWWWWWWWWWWWWWWWWWWWWWWWWWWWWWWWWWWWWWWWWWWWWWWWWWWWWWWWWWWWWWWWWWW
#...........................................T.SSSSWWWWWWWWWWWWWWWWWWWWWWWWWWWWWWWWWWWWWWWWWWWWWWWWWWWWWWWWWWWWWWWWWWWWWWWWWWWWWWWWWWWWWWWWWW
#................................................SSSSSSSSSWWWWWWWWWWWWWWWWWWWWWWWWWWWWWWWWWWWWWWWWWWWWWWWWWWWWWWWWWWWWWWWWWWWWWWWWWWWWWWWWWW
#...........@................T...........................SSSSSWWWWWWWWWWWWWWWWWWWWWWWWWWWWWWWWWWWWWWWWWWWWWWWWWWWWWWWWWWWWWWWWWWWWWWWWWWWWWW
#............................................................SSSSSSSSS#WWWWWWWWWWWWWWWWWWWWWWWWWWWWWWWWWWWWWWWWWWWWWWWWWWWWWWWWWWWWWWWWWWWWW
#.....................................................................#WWWWWWWWWWWWWWWWWWWWWWWWWWWWWWWWWWWWWWWWWWWWWWWWWWWWWWWWWWWWWWWWWWWWW
#.......T....................................T...............s........#WWWWWWWWWWWWWWWWWWWWWWWWWWWWWWWWWWWWWWWWWWWWWWWWWWWWWWWWWWWWWWWWWWWWW
#........................T............................................#WWWWWWWWWWWWWWWWWWWWWWWWWWWWWWWWWWWWWWWWWWWWWWWWWWWWWWWWWWWWWWWWWWWWW
#.....................................................T...............#WWWWWWWWWWWWWWWWWWWWWWWWWWWWWWWWWWWWWWWWWWWWWWWWWWWWWWWWWWWWWWWWWWWWW
#.....................................................................#WWWWWWWWWWWWWWWWWWWWWWWWWWWWWWWWWWWWWWWWWWWWWWWWWWWWWWWWWWWWWWWWWWWWW
#..........................................s..........................#WWWWWWWWWWWWWWWWWWWWWWWWWWWWWWWWWWWWWWWWWWWWWWWWWWWWWWWWWWWWWWWWWWWWW
#.....................................................................#WWWWWWWWWWWWWWWWWWWWWWWWWWWWWWWWWWWWWWWWWWWWWWWWWWWWWWWWWWWWWWWWWWWWW
#.......................T.............................................#############################################WWWWWWWWWWWWWWWWWWWWWWWW#
#................................................................................................................SSWWWWWWWWWWWWWWWWWWWWWWWW#
#......T........................................T.................................................................SSSSWWWWWWWWWWWWWWWWWWWWW#
#....................................................................................................................SSSSSSWWWWWWWWWWWWWWWW#
#................s.............................................................T...........................T..............SSSSSWWWWWWWWWWWW#
#...........................................................................................................................T.SSSSSWWWWWWWW#
######################################################################....................T................s......................SSSWWWWWW#
WWWWWWWWWWWWWWWWWWWWWWWWWWWWWWWWWWWWWWWWWWWWWWWWWWWWWWWWWWWWWWWWWWWWW#................................T.............................SSSSWWW#
WWWWWWWWWWWWWWWWWWWWWWWWWWWWWWWWWWWWWWWWWWWWWWWWWWWWWWWWWWWWWWWWWWWWW#..........................................T......................SSSS#
WWWWWWWWWWWWWWWWWWWWWWWWWWWWWWWWWWWWWWWWWWWWWWWWWWWWWWWWWWWWWWWWWWWWW#..........S..........................................................#
WWWWWWWWWWWWWWWWWWWWWWWWWWWWWWWWWWWWWWWWWWWWWWWWWWWWWWWWWWWWWWWWWWWWW#.........SWS....T.........................................T..........#
WWWWWWWWWWWWWWWWWWWWWWWWWWWWWWWWWWWWWWWWWWWWWWWWWWWWWWWWWWWWWWWWWWWWW#.........SWS....................................T....................#
WWWWWWWWWWWWWWWWWWWWWWWWWWWWWWWWWWWWWWWWWWWWWWWWWWWWWWWWWWWWWWWWWWWWW#.....T...SWS.........................................................#
WWWWWWWWWWWWWWWWWWWWWWWWWWWWWWWWWWWWWWWWWWWWWWWWWWWWWWWWWWWWWWWWWWWWW#.........SWS.........................................................#
WWWWWWWWWWWWWWWWWWWWWWWWWWWWWWWWWWWWWWWWWWWWWWWWWWWWWWWWWWWWWWWWWWWWW#........SWWS....................T....................................#
WWWWWWWWWWWWWWWWWWWWWWWWWWWWWWWWWWWWWWWWWWWWWWWWWWWWWWWWWWWWWWWWWWWWW#........SWS........T.......................................T.........#
WWWWWWWWWWWWWWWWWWWWWWWWWWWWWWWWWWWWWWWWWWWWWWWWWWWWWWWWWWWWWWWWWWWWW#........SWWS.........................................................#
WWWWWWWWWWWWWWWWWWWWWWWWWWWWWWWWWWWWWWWWWWWWWWWWWWWWWWWWWWWWWWWWWWWWW#SSSS....SWWS.................................T.......................#
WWWWWWWWWWWWWWWWWWWWWWWWWWWWWWWWWWWWWWWWWWWWWWWWWWWWWWWWWWWWWWWWWWWWW#WWWSSS..SSWS..................T......................................#
WWWWWWWWWWWWWWWWWWWWWWWWWWWWWWWWWWWWWWWWWWWWWWWWWWWWWWWWWWWWWWWWWWWWW#SSWWWWSSSSWS.........................................................#
WWWWWWWWWWWWWWWWWWWWWWWWWWWWWWWWWWWWWWWWWWWWWWWWWWWWWWWWWWWWWWWWWWWWW#.SSSSWWSSWWS..T......................................................#
######################################################################....SSWWWWSS.......................................T.................#
#..........................................................................SSSSSS......s................T..................................#
#.................................................................................................................................s........#
#..................................................T.......................................................................................#
#.......T..................................................................................................................................#
#...............................T....................................#######################################################################
#.............................................s.........T............#
#....................................................................#
#.....................T..............................................#
#....................................................................#
#....................................................................#
#....................................................................#
#....................................................T...............#
#................S...................................................#
#...............SWS............T.....................................#
#.......s.......SWS..................................................#
#...............SWS..................................................#
#..............SWWS..................................................#
#.............SWWS...................................................#
#..........T..SWS......................................T.............#
#............SWWS....................................................#
#............SWS.....................................................#
#............SWS.................T................s..................#
#...........SWWS.....................................................#
#...........SWS......................................................#
######################################################################


