###########################
#...s...SSSWWWWWWWWWWWWWWW#
#....T.....SSSSSSWWWWWWWWW#
#.............T..SSSWWWWWW#
#...................SSSWWW#
#..........@...........SSS#
#........................S#
#..BBB...........T.....s..#
#..BBB....................#
#..BBB.T............DDD...#
#..................DDDDDD.#
#....................DDDDD#
###########################