##############
#............#
#............#
#............#
#......@.....#
#............#
#............#
#............#
#............#
#............#
##############